Sparrow
Humming Bird
Pigeon
Humming Bird
Pigeon
Humming Bird
Pigeon
Pigeon
Humming Bird
Pigeon
Sparrow
Map
00000000000000000000000000000000000000000000000
00000000000000000000000000000000000000000000000
00000000000000000000000000000000000000000000000
00000000000000000000000000000000000000000000000
00000000000000000000000000000000000000000000000
00000000000000000000000000000000000000000000000
00000000000000000000000000000000000000000000000
00000000000000000000000000000000000000000000000
00000000000000000000000000000000000000000000000
00000000000000000000000000000000000000000000000
00000000000000000000000000000000000000000000000
00000000000000000000000000000000000000000000000
00000000000000000000000000000000000000000000000
00000000000000000000000000000000000000000000000
00000000000000000000000000000000000000000000000
00000000000000000000000000000000000000000000000
00000000000002220000222200020020020000020002000
00000000000020002000200000020200020000022322000
00000000000020302000222022022000020000020202000
00000000000022222000200000020200020000020002000
00000000000020002000203000020020022220320002000
11111111111111111111111111111111111111111111111
