Sparrow
Pigeon
Humming Bird
Pigeon
Pigeon
Sparrow
Humming Bird
Pigeon
Map
00000000000000000000000000000000000000000000000
00000000000000000000000000000000000000000000000
00000000000000000000000000000000000000000000000
00000000000000000000000000000000000000000000000
00000000000000000000000000000000000000000000000
00000000000000000000000000000000000000000000000
00000000000000000000000000000000000000000000000
00000000000000000000000000000000000000000000000
00000000000000000000000000000000000000000000000
00000000000000000000000000000000000000000000000
00000000000000000000000000000000000000000000000
00000000000000000000000000000000000000000000000
00000000000000000000000000000000000000000000000
00000000000000000000000000000000000000000000000
00000000000000000000000000000000000000000000000
00000000000000000000000000000000000000000000000
00000000000000000002002000200000200020000000000
00000000000000000002020000200000223220000000000
00000000000000000002200000200000202020000000000
00000000000000000002020000203000200020000000000
00000000000000000002302000222200230020000000000
11111111111111111111111111111111111111111111111
