Pigeon
Sparrow
Humming Bird
Pigeon
Sparrow
Sparrow
Pigeon
Humming Bird
Map
00000000000000000000000000000000000000000000000
00000000000000000000000000000000000000000000000
00000000000000000000000000000000000000000000000
00000000000000000000000000000000000000000000000
00000000000000000000000000000000000000000000000
00000000000000000000000000000000000000000000000
00000000000000000000000000000000000000000000000
00000000000000000000000000000000000000000000000
00000000000000000000000000000000000000000000000
00000000000000000000000000000000000000000000000
00000000000000000000000000000000000000000000000
00000000000000000000000000000000000000000000000
00000000000000000000000000000000000000000000000
00000000000000000000000000000000000000000000000
00000000000000000000003000000000000000000000000
00000000000000000000022000000022222000000000000
00000000000000000000200200000020000000000000000
00000000000000000000230200000020000000000000000
00000000000000000002222220000022200000000000000
00000000000000000002000020000020000000000000000
00000000000000000002030020000020000000000000000
11111111111111111111111111111111111111111111111
